Dimmers	KEYWORD1
Dimmer	KEYWORD1
DimmerController	KEYWORD1
begin	KEYWORD2
end	KEYWORD2
setIntensity	KEYWORD2
setEffect	KEYWORD2
setEffectData	KEYWORD2
clearEffect	KEYWORD2
run	KEYWORD2
enable	KEYWORD2
disable	KEYWORD2
setBipolar	KEYWORD2
setDimming	KEYWORD2
setInverse	KEYWORD2
setDirect	KEYWORD2
setNextInSequence	KEYWORD2
setPin	KEYWORD2
enabled	KEYWORD2
disabled	KEYWORD2
bipolar	KEYWORD2
dimming	KEYWORD2
inverse	KEYWORD2
direct	KEYWORD2
pin	KEYWORD2
initialized	KEYWORD2
nextInSequence	KEYWORD2